1111111111111
10010000000C1
1000011011o11
1P0011E0001C1
1111111111111