1111111111111
10010000000C1
1000011111111
1P0011E0CC0C1
1111111111111