11111111111111
100000PEC10001
10000000100001
11111111111111