11111101111101
10001000011101
1P000011E00C11
11111111110001